0000000000000000000000000000
0111111111111001111111111110
0100001000001001000001000010
0100001000001001000001000010
0100001000001001000001000010
0111111111111111111111111110
0100001001000000001001000010
0100001001000000001001000010
0111111001111001111001111110
0000001000001001000001000000
0000001000001001000001000000
0000001111111111111111000000
0000001000000990000001000000
0000001099999999999901000000
0000001099999999999901000000
0000001000000000000001000000
0000001000000000000001000000
0000001111111111111111000000
0000001000000000000001000000
0000001000000000000001000000
0111111111111001111111111110
0100001000001001000001000010
0100001000001001000001000010
0111001111111111111111001110
0001001000000000000001001000
0001001000000000000001001000
0111111111111001111111111110
0100000000001001000000000010
0100000000001001000000000010
0111111111111111111111111110
0000000000000000000000000000