00000000000000000000
02222222222222222220
02000200002000200020
02222222222222222220
02000000002000000020
02222222222222222220
02000002002002000020
02222222002002222220
02000002222222000020
02222222002002222220
02000002002002000020
02222222222222222220
02000000002000000020
02222222222222222220
00000000000000000000